7, 4, 1, 2, 3, 4

n, 4, 1, 2, 3, 2, 4
n, 3, 2, 3, 4, 1, 1
n, 4, n, n, 0, 2, 3
3, 2, 2, 4, 1, 1, 4
4, 1, 4, 2, 3, 2, n
2, 2, 3, 1, 0, 2, n
3, 1, 1, 2, 4, 4, n

0, 1, 1, 1, 1, 1, 1
0, 1, 1, 1, 1, 1, 1
0, 1, 0, 0, 0, 1, 1
1, 1, 1, 1, 1, 1, 1
1, 1, 1, 1, 1, 1, 0
1, 1, 1, 1, 0, 1, 0
1, 1, 1, 1, 1, 1, 0

0, 1, 2, 1, 1, 1, 2
0, 1, 1, 1, 2, 1, 1
0, 1, 0, 0, 0, 1, 1
1, 1, 1, 2, 1, 1, 1
1, 1, 1, 2, 1, 2, 0
1, 1, 2, 1, 0, 1, 0
1, 1, 1, 1, 1, 1, 0